!00000000000000000000000000000000|00000000000000000000000000000000|00000000000000000000000000000000|00000000000000000000000000000000|00000000000000000000000000000000!
!00000000000000000000000000000000|00000000000000000000000000000000|00000000000000000000000000000000|00000000000000000000000000000000|00000000000000000000000000000000!
!00000000000000000000000000000000|00000000000000000000000000000000|00000000000000000000000000000000|00000000000000000000000000000000|00000000000000000000000000000000!
!00000000000000000000000000000000|00000000000000000000000000000000|00000000000000000000000000000000|00000000000000000000000000000000|00000000000000000000000000000000!
!00000000000000000000000000000000|00000000000000000000000000000000|00000000000000000000000000000000|00000000000000000000000000000000|00000000000000000000000000000000!
!00000000000000000000000000000000|00000000000000000000000000000000|00000000000000000000000000000000|00000000000000000000000000000000|00000000000000000000000000000000!
!00000000000000000000000000000000|00000000000000000000000000000000|00000000000000000000000000000000|00000000000000000000000000000000|00000000000000000000000000000000!
!0000000000000c000000000000000000|00000000000000000000000000000000|00000000000000000000000000000000|00000000000000000000000000000000|00000000000000000000000000000000!
!00000000000000000000000000000000|00000000000000000000000000000000|00000000000000000000000000000000|00000000000000000000000000000000|00000000000000000000000000000000!
!00000000000000000000000000000000|00000000000000000000000000000000|00000000000000000000000000000000|00000000000000000000000000000000|00000000000000000000000000000000!
!00000000000000000000000000000000|00000000000000000000000000000000|00000000000000000000000000000000|00000000000000000000000000000000|00000000000000000000000000000000!
!00000000000000000000000000000000|00000000000000000000000000000000|00000000000000000000000000000000|00000000000000000000000000000000|00000000000000000000000000000000!
!00000000000000000000000000000000|00000000000000000000000000000000|00000000000000000000000000000000|00000000000000000000000000000000|00000000000000000000000000000000!
!00000000000000000000000000000000|00000000000000000000000000000000|00000000000000000000000000000000|00000000000000000000000000000000|00000000000000000000000000000000!
!00000000000000000000000000000000|000000000000000000?0000000000000|00000000000000000000000000000000|00000000000000000000000000000000|00000000000000000000000000000000!
!00000000000000000000000000000000|00000000000000000000000000000000|00000000000000000000000000000000|00000000000000000000000000000000|00000000000000000000000000000000!
!00000000000000000000000000000000|00000000000000000000000000000000|00000000000000000000000000000000|00000000000000000000000000000000|00000000000000000000000000000000!
!00000000000000000000000000000000|00000000000000000000000000000000|00000000000000000000000000000000|00000000000000000000000000000000|00000000000000000000000000000000!
!00000000000000000000000000000000|000000?000000000-?-?-00000000000|00000000000000000000000000000000|00000000000000000000000000000000|00000000000000000000000000000000!
!00000000000000000000000000000000|00000000000000000000000000000000|00000000000000000000000000000000|00000000000000000000000000000000|00000000000000000000000000000000!
!00000000000000000000000000000000|00000000000000000000000000000000|00000000000000000000000000000000|00000000000000000000000000000000|00000000000000000000000000000000!
!00m00000000000000000000000000000|00000000000g00000000000000000000|00000000000000000000000000000000|00000000000000000000000000000000|00000000000000000000000000000000!
!FFFFFFFFFFFFFFFFFFFFFFFFFFFFFFFF|FFFFFFFFFFFFFFFFFFFFFFFFFFFFFFFF|FFFFFFFFFFFFFFFFFFFFFFFFFFFFFFFF|FFFFFFFFFFFFFFFFFFFFFFFFFFFFFFFF|FFFFFFFFFFFFFFFFFFFFFFFFFFFFFFFF!
!FFFFFFFFFFFFFFFFFFFFFFFFFFFFFFFF|FFFFFFFFFFFFFFFFFFFFFFFFFFFFFFFF|FFFFFFFFFFFFFFFFFFFFFFFFFFFFFFFF|FFFFFFFFFFFFFFFFFFFFFFFFFFFFFFFF|FFFFFFFFFFFFFFFFFFFFFFFFFFFFFFFF!
